R 1920 1080
NO ./textures/
SO ./textures/
WE ./textures/
EA ./textures/

S ./textures/
F 40,240,250
C 240,50,240

1111111111111
1000000000001
1000000000001
1000000000001
1000000N00001
1111111111111