R 1920 1080
NO ./textures/NO
SO ./textures/SO
WE ./textures/WE
EA ./textures/EA

S ./textures/S
F 200,240, 0
C 240,50,240

1111111111111
1000000000001
10000 10000001
100000000000111111
1000000000001
1111111111111