R 500 500
NO ./textures/north.xpm
SO ./textures/south.xpm
WE ./textures/west.xpm
EA ./textures/east.xpm

S ./textures/eevee.xpm
F 200 ,240 ,0
C 240,50,240

1111111111111
1000200000001
100000N00001
1111111111111
1000000000001
1111111111111