R 1920 1080
NO ./textures/north.xpm
SO ./textures/south.xpm
WE ./textures/west.xpm
EA ./textures/east.xpm

S ./textures/eevee.xpm
F 0 ,0 ,0
C 255,255,255

1111111111111
100020N000001
100000000001
110000200011
1002000000001
1111111111111