R 1920 1080
NO ./code/images/greystone.xpm

SO ./code/images/mossy.xpm

WE ./code/images/redbrick.xpm

EA ./code/images/wood.xpm

S ./code/images/Monk.xpm

F 220,100,0
C 225,30,0

    1111111111111111111111111
    1000000000110000000000001
    1011000001110000002000001
    10010000000000000000000011111
111111111011000001110000000000001
100000000011000001110111111111111
11110111111111011100000010001
11110111111111011101010010001
11000000110101011100000010001
10002000000000001100000000001
10000000000000000001010010001
11000001110101011111011110N0111
11110111 1110101 101111010001
11111111 1111111 111111111111