R 2550 1234
NO ./textures/Biblio.xpm

SO ./textures/Fenetre.xpm


WE ./textures/Pendule.xpm

EA ./textures/Tele.xpm

S ./textures/eevee.xpm

F 220,100,200
C 225,30,200






    1111111111111111111111111
    1000000000110000000000001
    1011000001110000002000001
    10010000000000000000000011111
111111111011000001110000000000001
100000000011000001110111111111111
11110111111111011100000010001
11110111111111011101010010201
11000000110101011100000010001
10002000000000001100000000001
10000000000000000001010010001
11000001110101011111011110E0111
11110111 1110101 101111010001
11111111 1111111 111111111111
