R 500 500
F 100,100,100
C 0,0,1

NO                ./textures/Biblio.xpm

SO        ./textures/Fenetre.xpm

WE    ./textures/Pendule.xpm

EA         ./textures/Tele.xpm

S  ./textures/panda.xpm



                       1
                      121
                     12021
                    1200021
                   120000021
                  12000000021
                 1200000000021
                120000000000021
               12000000N00000021
              1200000000000000021
             120000000000000000021
            12222222222222222222221
            11111111111111111111111